{
  "background": "assets/level1_bg.png",
  "tile_size": 32,
  "tileset": "assets/tileset.png",
  "layout": [
    [1,1,1,1,1,1,1,1,1,1,1,1,1,1,1,1,1,1,1,1,1,1,1,1,1],
    [1,0,0,0,0,0,0,0,0,0,0,0,0,0,0,0,0,0,0,0,0,0,0,0,1],
    [1,0,2,2,2,0,0,0,0,0,0,0,0,0,0,0,0,0,3,3,3,0,0,0,1],
    [1,0,2,0,2,0,0,0,0,0,0,0,0,0,0,0,0,0,3,0,3,0,0,0,1],
    [1,0,2,2,2,0,0,0,0,0,0,0,0,0,0,0,0,0,3,3,3,0,0,0,1],
    [1,0,0,0,0,0,0,0,0,0,0,0,0,0,0,0,0,0,0,0,0,0,0,0,1],
    [1,1,1,1,1,1,1,1,1,1,1,1,1,1,1,1,1,1,1,1,1,1,1,1,1]
  ],
  "objects": [
    {"type": "tree", "position": [100, 200]},
    {"type": "rock", "position": [300, 400]}
  ],
  "npcs": [
    {"type": "elder", "position": [150, 250]},
    {"type": "merchant", "position": [400, 350]}
  ]
}
